1111111111
1P000001E1
1000000001
1000000001
1000000001
1CCCCCCCC1
1000000001
1000000001
10000000F1
1111111111
