11111
10001
10000
10001
11111
