11111
1P0C1
10C01
1CPE1
11111
