11111
1P001
10C01
1FFE1
11111
