11111
10001
00001
10001
11111
