11111
1P0C1
10C01
1C001
11111
