11111
1P001
00C01
100E1
11111
