1111111111111111111111
1P000000000000000000C1
10C0000000000000000001
1C0E000000000000000001
1111111111110111111111
