11111
1P0001
10C01
100E1
11111
