11111
1P0C1
1EC01
1C0E1
11111
