1111111111111111
1P000000000000E1
1000000000001111
1000000C00001C01
1000000000001001
1111111111111111
