11111
1P001
10C00
100E1
11111
