1111111111111111
1P00000000000001
1000000000001111
1000000C00001E01
1000000000001001
1111111111111111
