11111
100C1
10C01
1C0E1
11111
