111111
1P0C01
10C001
1C0E01
111111
