111111111
1P0000001
10000C001
100000001
100000001
100000001
100C000E1
111111111
