11111111111111
1P000000000001
10000000000001
10000000011111
100C00000E0001
10000000010001
10000000010001
11111111111111
