1111111111111111
1P000000000000E1
10000000C0001111
100000C000001001
100C000000001001
1111111111111111
