111111111111111111111111111111111111111111111111111111111111111111111111111111111111111
1P0C0CC0CCC0CCCC0CCCCC0CCCCCC0CCCCCCCC0CCCCCCCCC0CCCCCCCCCC0CCCCCCCCCCC0CCCCCCCCCCCC0E1
111111111111111111111111111111111111111111111111111111111111111111111111111111111111111
