11111111111111111111111111111111111111111111111
1001E100010000000000010000000000000010000000001
10000000010000000000010000000000000010000010001
10000000000010001000010000000000000001100000001
10C0P0C0010010000100010000011111110000010000001
10000000000010000010001001000011110000000000001
10000000010010000001001000010001110000010000001
11111101111111111111110000001111111111111100001
10000000000000000001000001000000000000000010001
10000000000000000001000001000000000000000010001
10000000000000000000000001000000011100000010001
10000011111111000001000001000000001000000010001
10000000001000000001000000000000001000000010001
10000000000000000001000001000000000011111110001
11111111111111111111111111111111111111111111111
