111111111111111111111111111111111111111111111111111111111111111111111111111111
1P0000000111111111111111111111111000000000000101010000000101000000000000000001
111100000000000000C11100000000000000111111000000000000111111000000000111100001
111000001000000011111111111100000000000000111111111111110000001010101111111111
100000000001110111111110000000000010100100000000001111111111111111100000111111
111111000000000C11000100000111111111101111000000000000000000000000000001111111
111010110101101110011100011110000000001E11110000000000000000000000000000001111
110000000000000000000000001111111110000000011111111111100000000000000011111111
100000000000000010000000000111111100000000000011111110000000000000000000011111
100000000111111111101111111111111000000111111111111000001111111111101001011111
100000000001111110001111111100000000011111111111000000000000111111111111111111
100011111111000000000000111110000011111111111111111111111111111111111111111111
111111111000000000000000001111111111111111111111111111111111111111111111111111
111110000000001110000000000000011111111111111100000000000000000111111111111111
1110000000000001000000000000001111111111100000000000000000000000000000000C1111
110000000000000100000000000000001111111000000000000000000000000001111111111111
100011111111000101000111111111000000000011111111111111110000000000000011111111
100111111111001110000011111110000011111111111111111111111111111111000001111111
101111111111000100111111100000111111111111111111111C00000000000000011111111111
101111111111110101111111101111111111111111111111111111111101111111011111111111
100000000000010101100000000000000000000000000000000000000000000000000000000001
111100C00011111111111111111111100C0000C0000C0000C0000C0011111111111111100000C1
111111111111111111111111111111111111111111111111111111111111111111111111111111
